Le nom pythonuc (Pythonic) est une convention utilisée dans la communauté Python pour donner des noms de variables, de fonctions et d'attributs en utilisant un style de casse spécifique. Voici le nom pythonuc correspondant à chaque mot-clé de Python :

- False : False
- None : None
- True : True
- and : and
- as : as
- assert : assert
- async : async
- await : await
- break : break
- class : class
- continue : continue
- def : def
- del : del
- elif : elif
- else : else
- except : except
- finally : finally
- for : for
- from : from
- global : global
- if : if
- import : import
- in : in
- is : is
- lambda : lambda
- nonlocal : nonlocal
- not : not
- or : or
- pass : pass
- raise : raise
- return : return
- try : try
- while : while
- with : with
- yield : yield

Il convient de noter que les mots-clés Python sont généralement utilisés en minuscules, conformément aux conventions de style Pythonic.